..........................
..........................
......##----------##......
......##----------##......
......##----------##......
..##~~##..##..##..##~~##..
..##~~##..##@@##..##~~##..
..##~~##..##@@##..##~~##..
..##~~##..##..##..##~~##..
......##..........##......
......##..........##......
..........##..##..........
..........##..##..........
##..####..........####..##
@@..####..........####..@@
..........######..........
..........######..........
..##........##........##..
..##........##........##..
..##%%%%%%%%##%%%%%%%%##..
..##%%%%%%%%##%%%%%%%%##..
..##%%%%%%%%##%%%%%%%%##..
..##%%%%%%%%##%%%%%%%%##..
..##.......####.......##..
...........#..#...........
...........#..#...........