..........................
..........................
@@@@@@@@@@@@..@@@@@@@@@@@@
-----------@..@-----------
-----------@..@-----------
-----------@..@-----------
%%%%%%%%%%%....%%%%%%%%%%%
%%%%%%%%%%%....%%%%%%%%%%%
%%%%%%%%%%%....%%%%%%%%%%%
%%%%%%%%%%%....%%%%%%%%%%%
~~~~~~~~~~~@..@~~~~~~~~~~~
~~~~~~~~~~~@..@~~~~~~~~~~~
~~~~~~~~~~~@..@~~~~~~~~~~~
~~~~~~~~~~~@..@~~~~~~~~~~~
###########@..@###########
###########@..@###########
###########@..@###########
###########@..@###########
...........@..@...........
...........@..@...........
.......@..@@..@@..@.......
.......@..........@.......
.......@..........@.......
.......@...@@@@...@.......
.......@...@..@...@.......
.......@...@..@...@.......