..........................
..........................
.#....#.#...#.#..#.#...#..
.#....#.##..#.#..#..#.#...
.#....#.#.#.#.#..#...#....
.#....#.#..##.#..#..#.#...
.####.#.#...#.####.#...#..
..........................
..........................
.#..#.####.#..#.#...#.....
.#..#.#..#.#..#.##..#.....
.#..#.###..#..#.#.#.#.....
.#..#.#..#.#..#.#..##.....
.####.###..####.#...#.....
..........................
..........................
..............#####.#..#..
................#...#..#..
................#...#..#..
................#...#..#..
................#...####..
..........................
..........................
...........@@@@...........
...........@..@...........
...........@..@...........